{
  "levelNumber": 19,
  "gridRows": 9,
  "gridColumns": 8,
  "blockLayout": [
    [3,3,3,3,3,3,3,3],
    [3,2,2,2,2,2,2,3],
    [3,2,1,1,1,1,2,3],
    [3,2,1,3,3,1,2,3],
    [3,2,1,3,3,1,2,3],
    [3,2,1,1,1,1,2,3],
    [3,2,2,2,2,2,2,3],
    [3,3,3,3,3,3,3,3],
    [0,0,0,3,3,0,0,0]
  ],
  "ballSpeedMultiplier": 1.5,
  "paddleWidthMultiplier": 0.75
}
