{
  "levelNumber": 20,
  "gridRows": 9,
  "gridColumns": 8,
  "blockLayout": [
    [3,3,3,3,3,3,3,3],
    [3,3,3,3,3,3,3,3],
    [3,3,2,2,2,2,3,3],
    [3,3,2,3,3,2,3,3],
    [3,3,2,3,3,2,3,3],
    [3,3,2,2,2,2,3,3],
    [3,3,3,3,3,3,3,3],
    [3,3,3,3,3,3,3,3],
    [1,1,1,1,1,1,1,1]
  ],
  "ballSpeedMultiplier": 1.6,
  "paddleWidthMultiplier": 0.7
}
