{
  "levelNumber": 18,
  "gridRows": 9,
  "gridColumns": 8,
  "blockLayout": [
    [3,0,3,0,0,3,0,3],
    [0,3,0,3,3,0,3,0],
    [3,0,3,0,0,3,0,3],
    [0,3,0,3,3,0,3,0],
    [3,0,3,3,3,3,0,3],
    [0,3,0,3,3,0,3,0],
    [3,0,3,0,0,3,0,3],
    [0,3,0,3,3,0,3,0],
    [3,0,3,0,0,3,0,3]
  ],
  "ballSpeedMultiplier": 1.5,
  "paddleWidthMultiplier": 0.75
}
