{
  "levelNumber": 16,
  "gridRows": 9,
  "gridColumns": 8,
  "blockLayout": [
    [3,3,0,0,0,0,3,3],
    [3,3,0,0,0,0,3,3],
    [0,0,2,2,2,2,0,0],
    [0,0,2,0,0,2,0,0],
    [0,0,2,0,0,2,0,0],
    [0,0,2,2,2,2,0,0],
    [3,3,0,0,0,0,3,3],
    [3,3,0,0,0,0,3,3],
    [1,1,1,1,1,1,1,1]
  ],
  "ballSpeedMultiplier": 1.45,
  "paddleWidthMultiplier": 0.8
}
