{
  "levelNumber": 17,
  "gridRows": 9,
  "gridColumns": 8,
  "blockLayout": [
    [1,1,1,1,1,1,1,1],
    [2,2,2,2,2,2,2,2],
    [1,0,1,0,0,1,0,1],
    [2,0,2,0,0,2,0,2],
    [3,3,3,3,3,3,3,3],
    [2,0,2,0,0,2,0,2],
    [1,0,1,0,0,1,0,1],
    [2,2,2,2,2,2,2,2],
    [1,1,1,1,1,1,1,1]
  ],
  "ballSpeedMultiplier": 1.45,
  "paddleWidthMultiplier": 0.75
}
